##########
#S #    E##
#  # #####
#    #   #
##########
