##########
#S #    E#
#  # #####
#    #   #
##########
@
