#######
#S    #
# ## E#
#     ##
#######
