5 10
##########
#S #S    E#
#  # #####
#    #   #
##########
