##########
#S #      #
#  # #####
#    #   #
##########