##########
#  #      #
#  # #####
#    #   #
##########
